BWBWBWBWBWBWBWBWBWBW
WWWWWWWWBWWWWWWWWWWW
BWBWBWBBBBBBBBBBBBBW
WWWWWWWWWWWWBWBWWWBW
BWBWBBBWBWBWBWBBBWBW
WWWWBWWWBWWWWWBWBWWW
BWBWBWBWBWBWBBBWBBBW
WWBWWWWWWWBWWWBWBWBW
BWBWBBBWBWBWBWBBBBBW
WWWWBWBWWWBWBWBWBWWW
BWBWBWBWBBBWBBBBBBBW
WWBWBWBWBWBWWWWWWWWW
BWBWBBBWBWBWBWBWBBBW
WWWWWWWWBWWWBWBWBWBW
BBBBBBBBBBBBBBBBBBBW
