BWBWBWBWBWBWBWB
WWBWWWWWWWBWWWB
BWBBBBBBBWBWBWB
WWWWBWWWWWBWBWB
BBBBBBBWBBBWBWB
WWWWWWBWWWBWWWB
BWBBBWBWBWBWBWB
WWBWBWWWBWBWWWB
BWBWBBBWBWBBBBB
WWWWWWWWWWWWWWB
BWBWBBBBBWBBBWB
WWWWWWWWWWWWWWB
BWBBBBBWBWBWBBB
WWBWBWWWBWWWBWB
BWBWBWBWBWBWBWB
WWBWWWWWBWWWWWB
BWBBBWBWBWBBBWB
WWWWBWWWBWWWBWB
BWBBBBBWBWBWBWB
WWWWWWWWWWWWWWW
