BBBBBBBBBBBBBBBBBBBB
BWWWWWWWWWWWWWWWWWWB
BBBBBWBBBBBBBWBBBWBB
BWBWWWBWBWBWBWWWWWWB
BWBBBWBWBBBBBWBWBWBB
BWWWWWBWBWWWBWWWBWWB
BBBBBWBWBWBBBBBWBBBB
BWBWBWWWWWWWWWBWBWWB
BWBWBBBBBWBBBBBWBBBB
BWWWWWBWBWBWWWWWWWWB
BWBWBWBBBWBBBBBBBBBB
BWBWWWWWBWWWWWWWWWWB
BWBBBWBWBWBBBBBWBWBB
BWWWWWWWBWWWWWWWWWWB
BBBBBBBBBBBBBBBBBBBB
