BBBBBBBBBBBBBBBBBBBB
BWBWBWWWWWWWWWBWWWWB
BWBWBWBWBWBBBWBBBWBB
BWWWBWWWWWWWBWWWBWBB
BWBWBBBWBBBBBWBWBBBB
BWWWBWWWBWBWBWWWBWBB
BBBWBWBWBBBBBBBWBBBB
BWBWWWWWWWBWBWWWBWBB
BWBBBWBWBWBBBBBWBBBB
BWWWBWWWWWBWBWWWBWWB
BWBWBWBBBBBWBWBWBWBB
BWWWWWBWBWBWBWBWBWWB
BBBBBBBWBBBBBWBWBWBB
BWWWWWWWBWWWWWWWWWWB
BBBBBBBBBBBBBBBBBBBB
