BBBBBBBBBBBBBBBBBBBB
BWWWBWBWWWWWWBWBWWWB
BBBWBWBBBWWBBBWBWBBB
BWBWWWWWWWWWWWWWWBWB
BWBBBBBBBWWBBBBBBBWB
BWWWWWWWBWWBWWWWWWWB
BWBBBBBBBWWBBBBBBBWB
BWWWWWBWWWWWWBWWWWWB
BWBWBBBBBWWBBBBBWBWB
BWBWWWWWWWWWWWWWWBWB
BWBBBBBBBWWBBBBBBBWB
BWBWBWBWWWWWWBWBWBWB
BWBWBWBWBWWBWBWBWBWB
BWWWWWWWWWWWWWWWWWWB
BBBBBBBBBBBBBBBBBBBB
