BBBBBBBBBBBBBBBBBBBB
BWBWWWWWWWWWWWWWWBWB
BWBWBWBBBWWBBBWBWBWB
BWBWBWBWBWWBWBWBWBWB
BWBBBBBBBWWBBBBBBBWB
BWWWWWWWWWWWWWWWWWWB
BWBBBBBWBWWBWBBBBBWB
BWWWBWBWWWWWWBWBWWWB
BWBBBWBWBWWBWBWBBBWB
BWWWWWBWBWWBWBWWWWWB
BWBBBWBWBWWBWBWBBBWB
BWWWWWWWWWWWWWWWWWWB
BWBWBBBBBWWBBBBBWBWB
BWWWWWWWWWWWWWWWWWWB
BBBBBBBBBBBBBBBBBBBB
